[
	[
		[0,0,0,0,0,0,0,0,0,0,0,0,0],
		[1,1,1,1,1,1,1,1,1,1,1,1,1],
		[7,7,7,7,7,7,7,7,7,7,7,7,7],
		[8,8,8,8,8,8,8,8,8,8,8,8,8],
		[10,10,10,10,10,10,10,10,10,10,10,10,10]
	]
]