[
	[
		[0,0,0,0,0,0,0,0,0,0,0,0,0],
		[1,1,1,1,1,1,1,1,1,1,1,1,1],
		[7,7,7,7,7,7,7,7,7,7,7,7,7],
		[8,8,8,8,8,8,8,8,8,8,8,8,8],
		[10,10,10,10,10,10,10,10,10,10,10,10,10]
	],
	[
		[0,0,0,12,0,0,0,0,0,12,0,0,0],
		[1,1,1,12,1,1,1,1,1,12,1,1,1],
		[7,7,7,12,7,7,7,7,7,12,7,7,7],
		[0,0,0,12,0,0,0,0,0,12,0,0,0],
		[4,4,4,12,4,4,4,4,4,12,4,4,4],
		[5,5,5,12,5,5,5,5,5,12,5,5,5],
		[0,0,0,12,0,0,0,0,0,12,0,0,0]
	],
	[
		[0,0,0,0,0,9,9,5,5,10,10,8,8],
		[0,0,0,0,0,9,9,5,5,10,10,8,8],
		[0,0,0,0,9,9,5,5,10,10,8,8,0],
		[0,0,0,0,9,9,5,5,10,10,8,8,0],
		[0,0,0,9,9,5,5,10,10,8,8,0,0],
		[0,0,0,9,9,5,5,10,10,8,8,0,0],
		[0,0,0,12,12,12,12,12,12,12,12,12,12]
	]
]